Name	expansion
Colony/Platinum	Prosperity
Shelters	Dark Ages
Academy	Renaissance
Acting Troupe	Renaissance
Advance	Empires
Advisor	Guilds
Alchemist	Alchemy
Alliance	Menagerie
Alms	Adventures
Altar	Dark Ages
Ambassador	Seaside
Amulet	Adventures
Animal Fair	Menagerie
Annex	Empires
Anvil	Prosperity
Apothecary	Alchemy
Apprentice	Alchemy
Aqueduct	Empires
Architects' Guild	Allies
Archive	Empires
Arena	Empires
Armory	Dark Ages
Artificer	Adventures
Artisan	Base
Astrolabe	Seaside
Augurs	Allies
Baker	Guilds
Ball	Adventures
Band of Nomads	Allies
Bandit	Base
Bandit Camp	Dark Ages
Bandit Fort	Empires
Band of Misfits	Dark Ages
Banish	Menagerie
Bank	Prosperity
Banquet	Empires
Barbarian	Allies
Bard	Nocturne
Bargain	Menagerie
Barge	Menagerie
Baron	Intrigue
Barracks	Renaissance
Basilica	Empires
Baths	Empires
Battlefield	Empires
Bauble	Allies
Bazaar	Seaside
Beggar	Dark Ages
Berserker	Hinterlands
Bishop	Prosperity
Black Cat	Menagerie
Black Market	Promo
Blessed Village	Nocturne
Blockade	Seaside
Bonfire	Adventures
Border Guard	Renaissance
Border Village	Hinterlands
Borrow	Adventures
Bounty Hunter	Menagerie
Bridge	Intrigue
Bridge Troll	Adventures
Broker	Allies
Bureaucrat	Base
Butcher	Guilds
Cache	Hinterlands
Camel Train	Menagerie
Canal	Renaissance
Candlestick Maker	Guilds
Capital	Empires
Capital City	Allies
Capitalism	Renaissance
Captain	Promo
Caravan	Seaside
Caravan Guard	Adventures
Cardinal	Menagerie
Cargo Ship	Renaissance
Carpenter	Allies
Cartographer	Hinterlands
Castles	Empires
Catacombs	Dark Ages
Catapult/Rocks	Empires
Cathedral	Renaissance
Cauldron	Hinterlands
Cavalry	Menagerie
Cave Dwellers	Allies
Cellar	Base
Cemetery	Nocturne
Changeling	Nocturne
Chapel	Base
Chariot Race	Empires
Charlatan	Prosperity
Charm	Empires
Church	Promo
Circle of Witches	Allies
Citadel	Renaissance
City	Prosperity
City-state	Allies
City Gate	Renaissance
City Quarter	Empires
Clashes	Allies
Clerk	Prosperity
Coastal Haven	Allies
Cobbler	Nocturne
Coin of the Realm	Adventures
Collection	Prosperity
Colonnade	Empires
Commerce	Menagerie
Conclave	Nocturne
Conquest	Empires
Conspirator	Intrigue
Contraband	Prosperity
Contract	Allies
Corsair	Seaside
Council Room	Base
Count	Dark Ages
Counterfeit	Dark Ages
Counting House	Prosperity
Courier	Allies
Courtier	Intrigue
Courtyard	Intrigue
Coven	Menagerie
Crafters' Guild	Allies
Crop Rotation	Renaissance
Crossroads	Hinterlands
Crown	Empires
Crypt	Nocturne
Crystal Ball	Prosperity
Cultist	Dark Ages
Cursed Village	Nocturne
Cutpurse	Seaside
Death Cart	Dark Ages
Defiled Shrine	Empires
Delay	Menagerie
Delve	Empires
Demand	Menagerie
Den of Sin	Nocturne
Desert Guides	Allies
Desperation	Menagerie
Destrier	Menagerie
Develop	Hinterlands
Devil's Workshop	Nocturne
Diplomat	Intrigue
Dismantle	Promo
Displace	Menagerie
Distant Lands	Adventures
Doctor	Guilds
Dominate	Empires
Donate	Empires
Druid	Nocturne
Ducat	Renaissance
Duchess	Hinterlands
Duke	Intrigue
Dungeon	Adventures
Duplicate	Adventures
Embargo	Seaside
Embassy	Hinterlands
Emissary	Allies
Encampment/Plunder	Empires
Enchantress	Empires
Enclave	Menagerie
Engineer	Empires
Enhance	Menagerie
Envoy	Promo
Exorcist	Nocturne
Expand	Prosperity
Expedition	Adventures
Experiment	Renaissance
Exploration	Renaissance
Explorer	Seaside
Fair	Renaissance
Fairgrounds	Cornucopia
Faithful Hound	Nocturne
Falconer	Menagerie
Familiar	Alchemy
Family of Inventors	Allies
Farmers' Market	Empires
Farming Village	Cornucopia
Farmland	Hinterlands
Fellowship of Scribes	Allies
Feodum	Dark Ages
Ferry	Adventures
Festival	Base
Fisherman	Menagerie
Fishing Village	Seaside
Flag Bearer	Renaissance
Fleet	Renaissance
Fool	Nocturne
Fool's Gold	Hinterlands
Forager	Dark Ages
Forest Dwellers	Allies
Forge	Prosperity
Fortress	Dark Ages
Forts	Allies
Fortune Teller	Cornucopia
Forum	Empires
Fountain	Empires
Galleria	Allies
Gamble	Menagerie
Gang of Pickpockets	Allies
Gardens	Base
Gatekeeper	Menagerie
Gear	Adventures
Ghost Ship	Seaside
Ghost Town	Nocturne
Giant	Adventures
Gladiator/Fortune	Empires
Goatherd	Menagerie
Golem	Alchemy
Goons	Prosperity
Governor	Promo
Grand Market	Prosperity
Graverobber	Dark Ages
Groom	Menagerie
Groundskeeper	Empires
Guard Dog	Hinterlands
Guardian	Nocturne
Guide	Adventures
Guildhall	Renaissance
Guildmaster	Allies
Haggler	Hinterlands
Hamlet	Cornucopia
Harbinger	Base
Harem	Intrigue
Harvest	Cornucopia
Haunted Woods	Adventures
Haven	Seaside
Herald	Guilds
Herbalist	Alchemy
Hermit	Dark Ages
Hideout	Renaissance
Highway	Hinterlands
Highwayman	Allies
Hireling	Adventures
Hoard	Prosperity
Horn of Plenty	Cornucopia
Horse Traders	Cornucopia
Hostelry	Menagerie
Hunter	Allies
Hunting Grounds	Dark Ages
Hunting Lodge	Menagerie
Hunting Party	Cornucopia
Idol	Nocturne
Ill-Gotten Gains	Hinterlands
Importer	Allies
Improve	Renaissance
Inheritance	Adventures
Inn	Hinterlands
Innkeeper	Allies
Innovation	Renaissance
Inventor	Renaissance
Invest	Menagerie
Investment	Prosperity
Ironmonger	Dark Ages
Ironworks	Intrigue
Island	Seaside
Island Folk	Allies
Jack of All Trades	Hinterlands
Jester	Cornucopia
Journeyman	Guilds
Junk Dealer	Dark Ages
Keep	Empires
Kiln	Menagerie
King's Court	Prosperity
Knights	Dark Ages
Laboratory	Base
Labyrinth	Empires
Lackeys	Renaissance
League of Bankers	Allies
League of Shopkeepers	Allies
Legionary	Empires
Leprechaun	Nocturne
Library	Base
Lighthouse	Seaside
Livery	Menagerie
Loan	Prosperity
Lookout	Seaside
Lost Arts	Adventures
Lost City	Adventures
Lurker	Intrigue
Magnate	Prosperity
Magpie	Adventures
Mandarin	Hinterlands
Marauder	Dark Ages
March	Menagerie
Margrave	Hinterlands
Market	Base
Market Towns	Allies
Market Square	Dark Ages
Marquis	Allies
Masquerade	Intrigue
Mastermind	Menagerie
Masterpiece	Guilds
Menagerie	Cornucopia
Merchant	Base
Merchant Camp	Allies
Merchant Guild	Guilds
Merchant Ship	Seaside
Messenger	Adventures
Militia	Base
Mill	Intrigue
Mine	Base
Mining Village	Intrigue
Minion	Intrigue
Mint	Prosperity
Miser	Adventures
Mission	Adventures
Moat	Base
Modify	Allies
Monastery	Nocturne
Moneylender	Base
Monkey	Seaside
Monument	Prosperity
Mountain Folk	Allies
Mountain Pass	Empires
Mountain Village	Renaissance
Mountebank	Prosperity
Museum	Empires
Mystic	Dark Ages
Native Village	Seaside
Navigator	Seaside
Necromancer	Nocturne
Night Watchman	Nocturne
Noble Brigand	Hinterlands
Nobles	Intrigue
Nomad Camp	Hinterlands
Nomads	Hinterlands
Oasis	Hinterlands
Obelisk	Empires
Odysseys	Allies
Old Witch	Renaissance
Oracle	Hinterlands
Orchard	Empires
Order of Astrologers	Allies
Order of Masons	Allies
Outpost	Seaside
Overlord	Empires
Paddock	Menagerie
Page	Adventures
Pageant	Renaissance
Palace	Empires
Pathfinding	Adventures
Patrician/Emporium	Empires
Patrol	Intrigue
Patron	Renaissance
Pawn	Intrigue
Peaceful Cult	Allies
Pearl Diver	Seaside
Peasant	Adventures
Peddler	Prosperity
Philosopher's Stone	Alchemy
Piazza	Renaissance
Pilgrimage	Adventures
Pillage	Dark Ages
Pirate	Seaside
Pirate Ship	Seaside
Pixie	Nocturne
Plan	Adventures
Plateau Shepherds	Allies
Plaza	Guilds
Poacher	Base
Pooka	Nocturne
Poor House	Dark Ages
Populate	Menagerie
Port	Adventures
Possession	Alchemy
Priest	Renaissance
Prince	Promo
Procession	Dark Ages
Pursue	Menagerie
Quarry	Prosperity
Quest	Adventures
Rabble	Prosperity
Raid	Adventures
Raider	Nocturne
Ranger	Adventures
Ratcatcher	Adventures
Rats	Dark Ages
Raze	Adventures
Reap	Menagerie
Rebuild	Dark Ages
Recruiter	Renaissance
Relic	Adventures
Remake	Cornucopia
Remodel	Base
Replace	Intrigue
Research	Renaissance
Ride	Menagerie
Ritual	Empires
Road Network	Renaissance
Rogue	Dark Ages
Royal Galley	Allies
Royal Blacksmith	Empires
Royal Carriage	Adventures
Royal Seal	Prosperity
Sacred Grove	Nocturne
Sacrifice	Empires
Sage	Dark Ages
Sailor	Seaside
Salt the Earth	Empires
Salvager	Seaside
Sanctuary	Menagerie
Sauna/Avanto	Promo
Save	Adventures
Scavenger	Dark Ages
Scepter	Renaissance
Scheme	Hinterlands
Scholar	Renaissance
Scouting Party	Adventures
Scrap	Menagerie
Scrying Pool	Alchemy
Sculptor	Renaissance
Sea Chart	Seaside
Sea Hag	Seaside
Seaway	Adventures
Sea Witch	Seaside
Secret Cave	Nocturne
Secret Passage	Intrigue
Seer	Renaissance
Seize the Day	Menagerie
Sentinel	Allies
Sentry	Base
Settlers/Bustling Village	Empires
Sewers	Renaissance
Shanty Town	Intrigue
Sheepdog	Menagerie
Shepherd	Nocturne
Silk Merchant	Renaissance
Silk Road	Hinterlands
Silos	Renaissance
Sinister Plot	Renaissance
Skirmisher	Allies
Skulk	Nocturne
Sleigh	Menagerie
Smithy	Base
Smugglers	Seaside
Snowy Village	Menagerie
Soothsayer	Guilds
Souk	Hinterlands
Specialist	Allies
Spice Merchant	Hinterlands
Spices	Renaissance
Squire	Dark Ages
Stables	Hinterlands
Stampede	Menagerie
Star Chart	Renaissance
Steward	Intrigue
Stockpile	Menagerie
Stonemason	Guilds
Storeroom	Dark Ages
Storyteller	Adventures
Summon	Promo
Supplies	Menagerie
Swamp Hag	Adventures
Swap	Allies
Swashbuckler	Renaissance
Swindler	Intrigue
Sycophant	Allies
Tactician	Seaside
Talisman	Prosperity
Tax	Empires
Taxman	Guilds
Temple	Empires
Throne Room	Base
Tiara	Prosperity
Tide Pools	Seaside
Toil	Menagerie
Tomb	Empires
Tormentor	Nocturne
Torturer	Intrigue
Tournament	Cornucopia
Tower	Empires
Town	Allies
Townsfolk	Allies
Tracker	Nocturne
Trade	Adventures
Trader	Hinterlands
Trade Route	Prosperity
Trading Post	Intrigue
Tragic Hero	Nocturne
Trail	Hinterlands
Training	Adventures
Transmogrify	Adventures
Transmute	Alchemy
Transport	Menagerie
Trappers' Lodge	Allies
Travelling Fair	Adventures
Treasure Map	Seaside
Treasurer	Renaissance
Treasure Trove	Adventures
Treasury	Seaside
Triumph	Empires
Triumphal Arch	Empires
Tunnel	Hinterlands
Underling	Allies
University	Alchemy
Upgrade	Intrigue
Urchin	Dark Ages
Vagrant	Dark Ages
Vampire	Nocturne
Vassal	Base
Vault	Prosperity
Venture	Prosperity
Villa	Empires
Village	Base
Village Green	Menagerie
Villain	Renaissance
Vineyard	Alchemy
Wall	Empires
Walled Village	Promo
Wandering Minstrel	Dark Ages
War Chest	Prosperity
Warehouse	Seaside
Watchtower	Prosperity
Wayfarer	Menagerie
Way of the Butterfly	Menagerie
Way of the Camel	Menagerie
Way of the Chameleon	Menagerie
Way of the Frog	Menagerie
Way of the Goat	Menagerie
Way of the Horse	Menagerie
Way of the Mole	Menagerie
Way of the Monkey	Menagerie
Way of the Mouse	Menagerie
Way of the Mule	Menagerie
Way of the Otter	Menagerie
Way of the Owl	Menagerie
Way of the Ox	Menagerie
Way of the Pig	Menagerie
Way of the Rat	Menagerie
Way of the Seal	Menagerie
Way of the Sheep	Menagerie
Way of the Squirrel	Menagerie
Way of the Turtle	Menagerie
Way of the Worm	Menagerie
Weaver	Hinterlands
Wedding	Empires
Werewolf	Nocturne
Wharf	Seaside
Wheelwright	Hinterlands
Wild Hunt	Empires
Windfall	Empires
Wine Merchant	Adventures
Wishing Well	Intrigue
Witch	Base
Witch's Hut	Hinterlands
Wizards	Allies
Wolf Den	Empires
Woodworkers' Guild	Allies
Worker's Village	Prosperity
Workshop	Base
Young Witch	Cornucopia
Ruins	Dark Ages
Potion	Alchemy
Spoils	Dark Ages
Ghost	Nocturne
Wish	Nocturne
Imp	Nocturne
Will-o'-Wisp	Nocturne
Horse	Menagerie
